Demographic,State,State Abbr,Winner,Biden %,Trump %,Biden Electoral Votes,Trump Electoral Votes,Electoral Votes Available
"$100,000+",alabama,AL,Trump,32,66,0,9,9
"$100,000+",washington,WA,Biden,61,36,12,0,12
"$100,000+",oregon,OR,Biden,65,33,7,0,7
"$100,000+",california,CA,Biden,62,36,55,0,55
"$100,000+",nevada,NV,Trump,44,54,0,6,6
"$100,000+",utah,UT,Trump,38,58,0,6,6
"$100,000+",arizona,AZ,Trump,44,53,0,11,11
"$100,000+",new-mexico,NM,Biden,56,41,5,0,5
"$100,000+",colorado,CO,Biden,59,38,9,0,9
"$100,000+",montana,MT,Trump,49,49,0,3,3
"$100,000+",texas,TX,Trump,41,58,0,38,38
"$100,000+",louisiana,LA,Trump,33,65,0,8,8
"$100,000+",missouri,MO,Trump,46,53,0,10,10
"$100,000+",iowa,IA,Trump,47,52,0,6,6
"$100,000+",minnesota,MN,Biden,53,44,10,0,10
"$100,000+",wisconsin,WI,Trump,47,51,0,10,10
"$100,000+",michigan,MI,Trump,49,50,0,16,16
"$100,000+",illinois,IL,Biden,59,38,20,0,20
"$100,000+",mississippi,MS,Trump,31,68,0,6,6
"$100,000+",georgia,GA,Trump,46,53,0,16,16
"$100,000+",florida,FL,Trump,41,58,0,29,29
"$100,000+",north-carolina,NC,Trump,49,50,0,15,15
"$100,000+",virginia,VA,Biden,53,45,13,0,13
"$100,000+",kentucky,KY,Trump,34,64,0,8,8
"$100,000+",pennsylvania,PA,Biden,50,49,20,0,20
"$100,000+",new-york,NY,Biden,56,43,29,0,29
"$100,000+",new-jersey,NJ,Biden,55,43,14,0,14
"$100,000+",massachusetts,MA,Biden,63,34,11,0,11
"$100,000+",maine,ME,Biden,58,37,4,0,4
"$100,000+",new-hampshire,NH,Biden,52,46,4,0,4
"$100,000+",connecticut,CT,Biden,59,39,7,0,7
"$100,000+",maryland,MD,Biden,67,31,10,0,10
"$100,000+",ohio,OH,Trump,42,56,0,18,18
"$100,000+",indiana,IN,Trump,41,56,0,11,11
"$100,000+",nebraska,NE,Trump,39,56,0,5,5
"$100,000+",kansas,KS,Trump,46,52,0,6,6
"$100,000+",tennessee,TN,Trump,32,67,0,11,11
"$100,000+",delaware,DE,Biden,60,39,3,0,3
"$100,000+",alaska,AK,Trump,38,60,0,3,3
"$100,000+",hawaii,HI,Biden,55,42,4,0,4
"$100,000+",south-carolina,SC,Trump,36,62,0,9,9
"$25,000 - $49,999",alabama,AL,Trump,36,63,0,9,9
"$25,000 - $49,999",washington,WA,Biden,57,41,12,0,12
"$25,000 - $49,999",oregon,OR,Biden,53,45,7,0,7
"$25,000 - $49,999",california,CA,Biden,64,34,55,0,55
"$25,000 - $49,999",nevada,NV,Biden,56,41,6,0,6
"$25,000 - $49,999",idaho,ID,Trump,27,70,0,4,4
"$25,000 - $49,999",utah,UT,Trump,39,58,0,6,6
"$25,000 - $49,999",arizona,AZ,Biden,52,46,11,0,11
"$25,000 - $49,999",new-mexico,NM,Biden,55,43,5,0,5
"$25,000 - $49,999",colorado,CO,Biden,55,43,9,0,9
"$25,000 - $49,999",montana,MT,Trump,41,57,0,3,3
"$25,000 - $49,999",oklahoma,OK,Trump,43,55,0,7,7
"$25,000 - $49,999",texas,TX,Trump,49,49,0,38,38
"$25,000 - $49,999",louisiana,LA,Trump,42,56,0,8,8
"$25,000 - $49,999",arkansas,AR,Trump,39,61,0,6,6
"$25,000 - $49,999",missouri,MO,Trump,43,55,0,10,10
"$25,000 - $49,999",iowa,IA,Trump,47,52,0,6,6
"$25,000 - $49,999",minnesota,MN,Biden,50,49,10,0,10
"$25,000 - $49,999",wisconsin,WI,Biden,52,46,10,0,10
"$25,000 - $49,999",michigan,MI,Biden,53,46,16,0,16
"$25,000 - $49,999",illinois,IL,Biden,61,38,20,0,20
"$25,000 - $49,999",mississippi,MS,Trump,40,58,0,6,6
"$25,000 - $49,999",georgia,GA,Biden,51,48,16,0,16
"$25,000 - $49,999",florida,FL,Biden,50,49,29,0,29
"$25,000 - $49,999",north-carolina,NC,Trump,48,50,0,15,15
"$25,000 - $49,999",virginia,VA,Biden,55,44,13,0,13
"$25,000 - $49,999",west-virginia,WV,Trump,28,70,0,5,5
"$25,000 - $49,999",kentucky,KY,Trump,36,61,0,8,8
"$25,000 - $49,999",pennsylvania,PA,Biden,50,48,20,0,20
"$25,000 - $49,999",new-york,NY,Biden,62,37,29,0,29
"$25,000 - $49,999",new-jersey,NJ,Biden,63,37,14,0,14
"$25,000 - $49,999",massachusetts,MA,Biden,69,29,11,0,11
"$25,000 - $49,999",maine,ME,Biden,50,47,4,0,4
"$25,000 - $49,999",new-hampshire,NH,Biden,59,40,4,0,4
"$25,000 - $49,999",connecticut,CT,Biden,62,35,7,0,7
"$25,000 - $49,999",maryland,MD,Biden,64,34,10,0,10
"$25,000 - $49,999",ohio,OH,Trump,47,51,0,18,18
"$25,000 - $49,999",indiana,IN,Trump,42,55,0,11,11
"$25,000 - $49,999",nebraska,NE,Trump,45,52,0,5,5
"$25,000 - $49,999",kansas,KS,Trump,42,55,0,6,6
"$25,000 - $49,999",tennessee,TN,Trump,42,56,0,11,11
"$25,000 - $49,999",delaware,DE,Biden,60,37,3,0,3
"$25,000 - $49,999",south-carolina,SC,Trump,45,54,0,9,9
"$50,000 - $74,999",alabama,AL,Trump,33,66,0,9,9
"$50,000 - $74,999",washington,WA,Biden,55,43,12,0,12
"$50,000 - $74,999",oregon,OR,Biden,55,42,7,0,7
"$50,000 - $74,999",california,CA,Biden,64,34,55,0,55
"$50,000 - $74,999",nevada,NV,Biden,52,46,6,0,6
"$50,000 - $74,999",idaho,ID,Trump,30,69,0,4,4
"$50,000 - $74,999",utah,UT,Trump,36,59,0,6,6
"$50,000 - $74,999",arizona,AZ,Biden,54,45,11,0,11
"$50,000 - $74,999",new-mexico,NM,Biden,52,46,5,0,5
"$50,000 - $74,999",colorado,CO,Biden,52,45,9,0,9
"$50,000 - $74,999",montana,MT,Trump,36,61,0,3,3
"$50,000 - $74,999",oklahoma,OK,Trump,22,78,0,7,7
"$50,000 - $74,999",texas,TX,Biden,50,49,38,0,38
"$50,000 - $74,999",louisiana,LA,Trump,33,65,0,8,8
"$50,000 - $74,999",arkansas,AR,Trump,31,62,0,6,6
"$50,000 - $74,999",missouri,MO,Trump,39,59,0,10,10
"$50,000 - $74,999",iowa,IA,Trump,44,54,0,6,6
"$50,000 - $74,999",minnesota,MN,Biden,54,44,10,0,10
"$50,000 - $74,999",wisconsin,WI,Trump,44,54,0,10,10
"$50,000 - $74,999",michigan,MI,Trump,47,50,0,16,16
"$50,000 - $74,999",illinois,IL,Biden,53,45,20,0,20
"$50,000 - $74,999",mississippi,MS,Trump,44,54,0,6,6
"$50,000 - $74,999",georgia,GA,Trump,49,49,0,16,16
"$50,000 - $74,999",florida,FL,Trump,45,54,0,29,29
"$50,000 - $74,999",north-carolina,NC,Trump,46,53,0,15,15
"$50,000 - $74,999",virginia,VA,Trump,49,49,0,13,13
"$50,000 - $74,999",west-virginia,WV,Trump,29,71,0,5,5
"$50,000 - $74,999",kentucky,KY,Trump,37,61,0,8,8
"$50,000 - $74,999",pennsylvania,PA,Trump,48,51,0,20,20
"$50,000 - $74,999",new-york,NY,Biden,54,45,29,0,29
"$50,000 - $74,999",new-jersey,NJ,Biden,56,42,14,0,14
"$50,000 - $74,999",massachusetts,MA,Biden,65,32,11,0,11
"$50,000 - $74,999",maine,ME,Biden,49,48,4,0,4
"$50,000 - $74,999",new-hampshire,NH,Trump,42,55,0,4,4
"$50,000 - $74,999",connecticut,CT,Biden,59,40,7,0,7
"$50,000 - $74,999",maryland,MD,Biden,64,34,10,0,10
"$50,000 - $74,999",ohio,OH,Trump,42,56,0,18,18
"$50,000 - $74,999",indiana,IN,Trump,38,60,0,11,11
"$50,000 - $74,999",nebraska,NE,Trump,35,63,0,5,5
"$50,000 - $74,999",kansas,KS,Trump,41,55,0,6,6
"$50,000 - $74,999",tennessee,TN,Trump,34,62,0,11,11
"$50,000 - $74,999",delaware,DE,Biden,51,45,3,0,3
"$50,000 - $74,999",alaska,AK,Trump,46,52,0,3,3
"$50,000 - $74,999",south-carolina,SC,Trump,41,58,0,9,9
"$75,000 - $99,999",alabama,AL,Trump,30,68,0,9,9
"$75,000 - $99,999",washington,WA,Biden,59,38,12,0,12
"$75,000 - $99,999",oregon,OR,Biden,59,39,7,0,7
"$75,000 - $99,999",california,CA,Biden,58,39,55,0,55
"$75,000 - $99,999",nevada,NV,Trump,43,54,0,6,6
"$75,000 - $99,999",utah,UT,Trump,37,60,0,6,6
"$75,000 - $99,999",arizona,AZ,Trump,47,52,0,11,11
"$75,000 - $99,999",new-mexico,NM,Trump,44,52,0,5,5
"$75,000 - $99,999",colorado,CO,Biden,53,46,9,0,9
"$75,000 - $99,999",montana,MT,Trump,35,62,0,3,3
"$75,000 - $99,999",texas,TX,Trump,41,58,0,38,38
"$75,000 - $99,999",louisiana,LA,Trump,31,68,0,8,8
"$75,000 - $99,999",missouri,MO,Trump,38,59,0,10,10
"$75,000 - $99,999",iowa,IA,Trump,35,63,0,6,6
"$75,000 - $99,999",minnesota,MN,Biden,52,46,10,0,10
"$75,000 - $99,999",wisconsin,WI,Trump,48,51,0,10,10
"$75,000 - $99,999",michigan,MI,Trump,43,56,0,16,16
"$75,000 - $99,999",illinois,IL,Biden,54,45,20,0,20
"$75,000 - $99,999",mississippi,MS,Trump,30,70,0,6,6
"$75,000 - $99,999",georgia,GA,Trump,48,50,0,16,16
"$75,000 - $99,999",florida,FL,Biden,52,47,29,0,29
"$75,000 - $99,999",north-carolina,NC,Biden,50,49,15,0,15
"$75,000 - $99,999",virginia,VA,Biden,54,44,13,0,13
"$75,000 - $99,999",kentucky,KY,Trump,36,63,0,8,8
"$75,000 - $99,999",pennsylvania,PA,Trump,48,51,0,20,20
"$75,000 - $99,999",new-york,NY,Trump,47,51,0,29,29
"$75,000 - $99,999",new-jersey,NJ,Biden,54,46,14,0,14
"$75,000 - $99,999",massachusetts,MA,Biden,65,34,11,0,11
"$75,000 - $99,999",maine,ME,Biden,56,43,4,0,4
"$75,000 - $99,999",new-hampshire,NH,Biden,56,41,4,0,4
"$75,000 - $99,999",connecticut,CT,Biden,53,46,7,0,7
"$75,000 - $99,999",maryland,MD,Biden,60,38,10,0,10
"$75,000 - $99,999",ohio,OH,Trump,45,53,0,18,18
"$75,000 - $99,999",indiana,IN,Trump,37,60,0,11,11
"$75,000 - $99,999",nebraska,NE,Trump,36,63,0,5,5
"$75,000 - $99,999",kansas,KS,Trump,32,68,0,6,6
"$75,000 - $99,999",tennessee,TN,Trump,36,63,0,11,11
"$75,000 - $99,999",delaware,DE,Biden,52,46,3,0,3
"$75,000 - $99,999",alaska,AK,Trump,40,51,0,3,3
"$75,000 - $99,999",south-carolina,SC,Trump,38,60,0,9,9
18-29,alabama,AL,Trump,45,52,0,9,9
18-29,arizona,AZ,Biden,59,37,11,0,11
18-29,california,CA,Biden,73,24,55,0,55
18-29,colorado,CO,Biden,64,33,9,0,9
18-29,connecticut,CT,Biden,66,30,7,0,7
18-29,delaware,DE,Biden,59,39,3,0,3
18-29,florida,FL,Biden,64,34,29,0,29
18-29,georgia,GA,Biden,58,39,16,0,16
18-29,illinois,IL,Biden,61,34,20,0,20
18-29,indiana,IN,Trump,45,51,0,11,11
18-29,iowa,IA,Biden,49,48,6,0,6
18-29,kansas,KS,Trump,45,50,0,6,6
18-29,kentucky,KY,Trump,46,50,0,8,8
18-29,louisiana,LA,Biden,54,43,8,0,8
18-29,maine,ME,Biden,61,33,4,0,4
18-29,maryland,MD,Biden,76,21,10,0,10
18-29,massachusetts,MA,Biden,69,29,11,0,11
18-29,michigan,MI,Biden,62,36,16,0,16
18-29,minnesota,MN,Biden,66,32,10,0,10
18-29,mississippi,MS,Trump,47,50,0,6,6
18-29,missouri,MO,Biden,50,46,10,0,10
18-29,nebraska,NE,Biden,55,41,5,0,5
18-29,nevada,NV,Biden,64,31,6,0,6
18-29,new-hampshire,NH,Biden,62,34,4,0,4
18-29,new-jersey,NJ,Biden,62,37,14,0,14
18-29,new-mexico,NM,Biden,60,39,5,0,5
18-29,new-york,NY,Biden,60,37,29,0,29
18-29,north-carolina,NC,Biden,57,41,15,0,15
18-29,ohio,OH,Biden,54,43,18,0,18
18-29,oklahoma,OK,Biden,55,43,7,0,7
18-29,oregon,OR,Biden,63,31,7,0,7
18-29,pennsylvania,PA,Biden,59,39,20,0,20
18-29,south-carolina,SC,Biden,53,43,9,0,9
18-29,tennessee,TN,Trump,47,49,0,11,11
18-29,texas,TX,Biden,62,35,38,0,38
18-29,utah,UT,Trump,47,48,0,6,6
18-29,virginia,VA,Biden,64,31,13,0,13
18-29,washington,WA,Biden,69,26,12,0,12
18-29,wisconsin,WI,Biden,58,39,10,0,10
30-44,alabama,AL,Trump,40,57,0,9,9
30-44,alaska,AK,Trump,41,56,0,3,3
30-44,arizona,AZ,Biden,53,44,11,0,11
30-44,arkansas,AR,Trump,43,55,0,6,6
30-44,california,CA,Biden,68,29,55,0,55
30-44,colorado,CO,Biden,62,35,9,0,9
30-44,connecticut,CT,Biden,60,38,7,0,7
30-44,delaware,DE,Biden,66,31,3,0,3
30-44,florida,FL,Biden,52,46,29,0,29
30-44,georgia,GA,Biden,53,45,16,0,16
30-44,illinois,IL,Biden,63,35,20,0,20
30-44,indiana,IN,Trump,47,50,0,11,11
30-44,iowa,IA,Trump,47,51,0,6,6
30-44,kansas,KS,Trump,44,50,0,6,6
30-44,kentucky,KY,Trump,34,65,0,8,8
30-44,louisiana,LA,Trump,38,59,0,8,8
30-44,maine,ME,Biden,53,43,4,0,4
30-44,maryland,MD,Biden,67,31,10,0,10
30-44,massachusetts,MA,Biden,70,26,11,0,11
30-44,michigan,MI,Biden,50,47,16,0,16
30-44,minnesota,MN,Biden,56,41,10,0,10
30-44,mississippi,MS,Trump,46,51,0,6,6
30-44,missouri,MO,Trump,45,51,0,10,10
30-44,montana,MT,Trump,46,50,0,3,3
30-44,nebraska,NE,Trump,42,55,0,5,5
30-44,nevada,NV,Biden,60,37,6,0,6
30-44,new-hampshire,NH,Biden,56,41,4,0,4
30-44,new-jersey,NJ,Biden,63,36,14,0,14
30-44,new-mexico,NM,Biden,58,39,5,0,5
30-44,new-york,NY,Biden,58,40,29,0,29
30-44,north-carolina,NC,Biden,50,48,15,0,15
30-44,ohio,OH,Trump,46,51,0,18,18
30-44,oklahoma,OK,Trump,36,62,0,7,7
30-44,oregon,OR,Biden,64,33,7,0,7
30-44,pennsylvania,PA,Biden,54,45,20,0,20
30-44,south-carolina,SC,Trump,48,49,0,9,9
30-44,tennessee,TN,Trump,39,58,0,11,11
30-44,texas,TX,Biden,51,48,38,0,38
30-44,utah,UT,Trump,43,50,0,6,6
30-44,virginia,VA,Biden,54,43,13,0,13
30-44,washington,WA,Biden,59,38,12,0,12
30-44,west-virginia,WV,Trump,27,69,0,5,5
30-44,wisconsin,WI,Biden,54,45,10,0,10
45-64,alabama,AL,Trump,36,63,0,9,9
45-64,alaska,AK,Trump,39,57,0,3,3
45-64,arizona,AZ,Trump,46,53,0,11,11
45-64,arkansas,AR,Trump,33,64,0,6,6
45-64,california,CA,Biden,60,38,55,0,55
45-64,colorado,CO,Trump,48,49,0,9,9
45-64,connecticut,CT,Biden,57,42,7,0,7
45-64,delaware,DE,Biden,58,40,3,0,3
45-64,florida,FL,Trump,43,56,0,29,29
45-64,georgia,GA,Trump,47,52,0,16,16
45-64,hawaii,HI,Biden,64,33,4,0,4
45-64,idaho,ID,Trump,30,68,0,4,4
45-64,illinois,IL,Biden,53,45,20,0,20
45-64,indiana,IN,Trump,35,63,0,11,11
45-64,iowa,IA,Trump,45,54,0,6,6
45-64,kansas,KS,Trump,39,60,0,6,6
45-64,kentucky,KY,Trump,34,65,0,8,8
45-64,louisiana,LA,Trump,39,59,0,8,8
45-64,maine,ME,Trump,49,49,0,4,4
45-64,maryland,MD,Biden,62,37,10,0,10
45-64,massachusetts,MA,Biden,60,38,11,0,11
45-64,michigan,MI,Trump,47,52,0,16,16
45-64,minnesota,MN,Trump,48,50,0,10,10
45-64,mississippi,MS,Trump,40,58,0,6,6
45-64,missouri,MO,Trump,38,61,0,10,10
45-64,montana,MT,Trump,34,63,0,3,3
45-64,nebraska,NE,Trump,35,63,0,5,5
45-64,nevada,NV,Trump,45,53,0,6,6
45-64,new-hampshire,NH,Trump,48,51,0,4,4
45-64,new-jersey,NJ,Biden,55,44,14,0,14
45-64,new-mexico,NM,Biden,49,48,5,0,5
45-64,new-york,NY,Biden,57,42,29,0,29
45-64,north-carolina,NC,Trump,48,52,0,15,15
45-64,ohio,OH,Trump,42,56,0,18,18
45-64,oklahoma,OK,Trump,29,70,0,7,7
45-64,oregon,OR,Biden,53,46,7,0,7
45-64,pennsylvania,PA,Trump,46,52,0,20,20
45-64,rhode-island,RI,Trump,49,50,0,4,4
45-64,south-carolina,SC,Trump,39,60,0,9,9
45-64,tennessee,TN,Trump,35,64,0,11,11
45-64,texas,TX,Trump,41,57,0,38,38
45-64,utah,UT,Trump,33,64,0,6,6
45-64,virginia,VA,Biden,51,48,13,0,13
45-64,washington,WA,Biden,58,40,12,0,12
45-64,west-virginia,WV,Trump,30,69,0,5,5
45-64,wisconsin,WI,Trump,47,52,0,10,10
65,alabama,AL,Trump,30,69,0,9,9
65,alaska,AK,Trump,48,52,0,3,3
65,arizona,AZ,Trump,46,53,0,11,11
65,arkansas,AR,Trump,27,71,0,6,6
65,california,CA,Biden,61,38,55,0,55
65,colorado,CO,Biden,53,46,9,0,9
65,connecticut,CT,Biden,59,39,7,0,7
65,delaware,DE,Biden,54,45,3,0,3
65,florida,FL,Trump,44,55,0,29,29
65,georgia,GA,Trump,43,55,0,16,16
65,hawaii,HI,Biden,67,32,4,0,4
65,idaho,ID,Trump,34,63,0,4,4
65,illinois,IL,Biden,57,41,20,0,20
65,indiana,IN,Trump,41,57,0,11,11
65,iowa,IA,Trump,42,57,0,6,6
65,kansas,KS,Trump,40,59,0,6,6
65,kentucky,KY,Trump,37,62,0,8,8
65,louisiana,LA,Trump,36,64,0,8,8
65,maine,ME,Biden,55,42,4,0,4
65,maryland,MD,Biden,64,35,10,0,10
65,massachusetts,MA,Biden,67,32,11,0,11
65,michigan,MI,Biden,51,48,16,0,16
65,minnesota,MN,Trump,49,50,0,10,10
65,mississippi,MS,Trump,32,67,0,6,6
65,missouri,MO,Trump,38,61,0,10,10
65,montana,MT,Trump,40,58,0,3,3
65,nebraska,NE,Trump,35,64,0,5,5
65,nevada,NV,Trump,41,58,0,6,6
65,new-hampshire,NH,Biden,53,46,4,0,4
65,new-jersey,NJ,Biden,54,46,14,0,14
65,new-mexico,NM,Biden,55,44,5,0,5
65,new-york,NY,Biden,52,48,29,0,29
65,north-carolina,NC,Trump,45,55,0,15,15
65,ohio,OH,Trump,44,55,0,18,18
65,oklahoma,OK,Trump,28,71,0,7,7
65,oregon,OR,Biden,54,45,7,0,7
65,pennsylvania,PA,Trump,47,53,0,20,20
65,rhode-island,RI,Biden,59,39,4,0,4
65,south-carolina,SC,Trump,42,57,0,9,9
65,tennessee,TN,Trump,35,64,0,11,11
65,texas,TX,Trump,41,59,0,38,38
65,utah,UT,Trump,32,66,0,6,6
65,virginia,VA,Biden,53,46,13,0,13
65,washington,WA,Biden,55,44,12,0,12
65,west-virginia,WV,Trump,30,69,0,5,5
65,wisconsin,WI,Trump,46,53,0,10,10
Catholic,alabama,AL,Trump,40,59,0,9,9
Catholic,arizona,AZ,Biden,51,49,11,0,11
Catholic,california,CA,Biden,65,33,55,0,55
Catholic,colorado,CO,Trump,49,49,0,9,9
Catholic,connecticut,CT,Trump,47,51,0,7,7
Catholic,delaware,DE,Trump,48,51,0,3,3
Catholic,florida,FL,Trump,45,55,0,29,29
Catholic,georgia,GA,Trump,46,53,0,16,16
Catholic,illinois,IL,Biden,51,48,20,0,20
Catholic,indiana,IN,Trump,36,60,0,11,11
Catholic,iowa,IA,Trump,46,53,0,6,6
Catholic,kansas,KS,Trump,42,55,0,6,6
Catholic,kentucky,KY,Trump,38,60,0,8,8
Catholic,louisiana,LA,Trump,28,71,0,8,8
Catholic,maine,ME,Biden,50,49,4,0,4
Catholic,maryland,MD,Biden,51,48,10,0,10
Catholic,massachusetts,MA,Biden,58,41,11,0,11
Catholic,michigan,MI,Trump,44,55,0,16,16
Catholic,minnesota,MN,Trump,45,53,0,10,10
Catholic,missouri,MO,Trump,39,60,0,10,10
Catholic,montana,MT,Trump,50,50,0,3,3
Catholic,nebraska,NE,Trump,31,65,0,5,5
Catholic,nevada,NV,Trump,45,53,0,6,6
Catholic,new-hampshire,NH,Trump,43,56,0,4,4
Catholic,new-jersey,NJ,Trump,47,52,0,14,14
Catholic,new-mexico,NM,Biden,57,42,5,0,5
Catholic,new-york,NY,Trump,47,53,0,29,29
Catholic,north-carolina,NC,Trump,45,53,0,15,15
Catholic,ohio,OH,Trump,42,57,0,18,18
Catholic,oregon,OR,Biden,56,42,7,0,7
Catholic,pennsylvania,PA,Trump,44,55,0,20,20
Catholic,rhode-island,RI,Trump,49,50,0,4,4
Catholic,south-carolina,SC,Trump,40,60,0,9,9
Catholic,tennessee,TN,Trump,37,61,0,11,11
Catholic,texas,TX,Biden,51,48,38,0,38
Catholic,virginia,VA,Trump,47,50,0,13,13
Catholic,washington,WA,Biden,56,43,12,0,12
Catholic,wisconsin,WI,Trump,43,56,0,10,10
College Grad,alabama,AL,Trump,39,58,0,9,9
College Grad,alaska,AK,Biden,48,44,3,0,3
College Grad,arizona,AZ,Biden,52,46,11,0,11
College Grad,arkansas,AR,Trump,47,53,0,6,6
College Grad,california,CA,Biden,68,30,55,0,55
College Grad,colorado,CO,Biden,63,34,9,0,9
College Grad,connecticut,CT,Biden,64,34,7,0,7
College Grad,delaware,DE,Biden,57,39,3,0,3
College Grad,florida,FL,Trump,49,50,0,29,29
College Grad,georgia,GA,Biden,51,47,16,0,16
College Grad,hawaii,HI,Biden,75,22,4,0,4
College Grad,idaho,ID,Trump,37,57,0,4,4
College Grad,illinois,IL,Biden,61,38,20,0,20
College Grad,indiana,IN,Trump,45,51,0,11,11
College Grad,iowa,IA,Trump,48,49,0,6,6
College Grad,kansas,KS,Trump,47,52,0,6,6
College Grad,kentucky,KY,Trump,41,56,0,8,8
College Grad,louisiana,LA,Trump,39,60,0,8,8
College Grad,maine,ME,Biden,68,29,4,0,4
College Grad,maryland,MD,Biden,69,29,10,0,10
College Grad,massachusetts,MA,Biden,73,25,11,0,11
College Grad,michigan,MI,Biden,55,44,16,0,16
College Grad,minnesota,MN,Biden,58,40,10,0,10
College Grad,mississippi,MS,Trump,43,56,0,6,6
College Grad,missouri,MO,Trump,47,51,0,10,10
College Grad,montana,MT,Biden,49,48,3,0,3
College Grad,nebraska,NE,Trump,44,52,0,5,5
College Grad,nevada,NV,Biden,54,44,6,0,6
College Grad,new-hampshire,NH,Biden,58,40,4,0,4
College Grad,new-jersey,NJ,Biden,63,36,14,0,14
College Grad,new-mexico,NM,Biden,56,40,5,0,5
College Grad,new-york,NY,Biden,67,32,29,0,29
College Grad,north-carolina,NC,Biden,54,44,15,0,15
College Grad,ohio,OH,Biden,49,48,18,0,18
College Grad,oklahoma,OK,Trump,30,69,0,7,7
College Grad,oregon,OR,Biden,67,30,7,0,7
College Grad,pennsylvania,PA,Biden,57,41,20,0,20
College Grad,rhode-island,RI,Biden,53,45,4,0,4
College Grad,south-carolina,SC,Trump,40,58,0,9,9
College Grad,tennessee,TN,Trump,38,60,0,11,11
College Grad,texas,TX,Trump,46,51,0,38,38
College Grad,utah,UT,Trump,42,52,0,6,6
College Grad,virginia,VA,Biden,61,36,13,0,13
College Grad,washington,WA,Biden,65,33,12,0,12
College Grad,west-virginia,WV,Trump,37,56,0,5,5
College Grad,wisconsin,WI,Biden,52,47,10,0,10
Did not vote in 2016,alabama,AL,Trump,41,57,0,9,9
Did not vote in 2016,arizona,AZ,Biden,57,41,11,0,11
Did not vote in 2016,arkansas,AR,Trump,37,58,0,6,6
Did not vote in 2016,california,CA,Biden,71,26,55,0,55
Did not vote in 2016,colorado,CO,Biden,61,36,9,0,9
Did not vote in 2016,connecticut,CT,Biden,64,32,7,0,7
Did not vote in 2016,delaware,DE,Biden,61,36,3,0,3
Did not vote in 2016,florida,FL,Biden,56,42,29,0,29
Did not vote in 2016,georgia,GA,Biden,59,38,16,0,16
Did not vote in 2016,illinois,IL,Biden,59,38,20,0,20
Did not vote in 2016,indiana,IN,Trump,47,49,0,11,11
Did not vote in 2016,iowa,IA,Biden,52,46,6,0,6
Did not vote in 2016,kansas,KS,Trump,40,58,0,6,6
Did not vote in 2016,kentucky,KY,Trump,47,51,0,8,8
Did not vote in 2016,louisiana,LA,Biden,51,47,8,0,8
Did not vote in 2016,maine,ME,Biden,53,46,4,0,4
Did not vote in 2016,maryland,MD,Biden,69,31,10,0,10
Did not vote in 2016,massachusetts,MA,Biden,68,30,11,0,11
Did not vote in 2016,michigan,MI,Biden,53,45,16,0,16
Did not vote in 2016,minnesota,MN,Biden,62,37,10,0,10
Did not vote in 2016,mississippi,MS,Trump,42,57,0,6,6
Did not vote in 2016,missouri,MO,Trump,46,51,0,10,10
Did not vote in 2016,nebraska,NE,Biden,52,47,5,0,5
Did not vote in 2016,nevada,NV,Biden,56,40,6,0,6
Did not vote in 2016,new-hampshire,NH,Biden,68,32,4,0,4
Did not vote in 2016,new-jersey,NJ,Biden,61,38,14,0,14
Did not vote in 2016,new-mexico,NM,Biden,65,33,5,0,5
Did not vote in 2016,new-york,NY,Biden,57,40,29,0,29
Did not vote in 2016,north-carolina,NC,Biden,52,46,15,0,15
Did not vote in 2016,ohio,OH,Biden,50,48,18,0,18
Did not vote in 2016,oklahoma,OK,Trump,43,52,0,7,7
Did not vote in 2016,oregon,OR,Biden,57,39,7,0,7
Did not vote in 2016,pennsylvania,PA,Biden,56,43,20,0,20
Did not vote in 2016,south-carolina,SC,Biden,51,48,9,0,9
Did not vote in 2016,tennessee,TN,Trump,43,54,0,11,11
Did not vote in 2016,texas,TX,Biden,54,44,38,0,38
Did not vote in 2016,utah,UT,Trump,42,52,0,6,6
Did not vote in 2016,virginia,VA,Biden,55,42,13,0,13
Did not vote in 2016,washington,WA,Biden,64,32,12,0,12
Did not vote in 2016,wisconsin,WI,Biden,57,42,10,0,10
Early Voting,alabama,AL,Biden,62,37,9,0,9
Early Voting,alaska,AK,Biden,55,42,3,0,3
Early Voting,arizona,AZ,Biden,52,46,11,0,11
Early Voting,arkansas,AR,Trump,36,61,0,6,6
Early Voting,california,CA,Biden,68,30,55,0,55
Early Voting,colorado,CO,Biden,58,39,9,0,9
Early Voting,connecticut,CT,Biden,79,19,7,0,7
Early Voting,delaware,DE,Biden,80,18,3,0,3
Early Voting,florida,FL,Biden,52,47,29,0,29
Early Voting,georgia,GA,Biden,54,44,16,0,16
Early Voting,hawaii,HI,Biden,65,33,4,0,4
Early Voting,idaho,ID,Trump,46,50,0,4,4
Early Voting,illinois,IL,Biden,67,31,20,0,20
Early Voting,indiana,IN,Trump,47,51,0,11,11
Early Voting,iowa,IA,Biden,57,42,6,0,6
Early Voting,kansas,KS,Biden,52,45,6,0,6
Early Voting,kentucky,KY,Trump,42,57,0,8,8
Early Voting,louisiana,LA,Trump,47,52,0,8,8
Early Voting,maine,ME,Biden,62,35,4,0,4
Early Voting,maryland,MD,Biden,71,27,10,0,10
Early Voting,massachusetts,MA,Biden,76,22,11,0,11
Early Voting,michigan,MI,Biden,63,36,16,0,16
Early Voting,minnesota,MN,Biden,65,34,10,0,10
Early Voting,mississippi,MS,Biden,61,38,6,0,6
Early Voting,missouri,MO,Biden,60,39,10,0,10
Early Voting,montana,MT,Trump,42,55,0,3,3
Early Voting,nebraska,NE,Trump,49,49,0,5,5
Early Voting,nevada,NV,Biden,53,45,6,0,6
Early Voting,new-hampshire,NH,Biden,73,26,4,0,4
Early Voting,new-jersey,NJ,Biden,59,39,14,0,14
Early Voting,new-mexico,NM,Biden,57,41,5,0,5
Early Voting,new-york,NY,Biden,70,29,29,0,29
Early Voting,north-carolina,NC,Biden,52,46,15,0,15
Early Voting,north-dakota,ND,Trump,39,59,0,3,3
Early Voting,ohio,OH,Biden,53,45,18,0,18
Early Voting,oklahoma,OK,Trump,45,53,0,7,7
Early Voting,oregon,OR,Biden,57,41,7,0,7
Early Voting,pennsylvania,PA,Biden,73,26,20,0,20
Early Voting,rhode-island,RI,Biden,72,26,4,0,4
Early Voting,south-carolina,SC,Biden,56,43,9,0,9
Early Voting,south-dakota,SD,Trump,42,55,0,3,3
Early Voting,tennessee,TN,Trump,40,58,0,11,11
Early Voting,texas,TX,Trump,49,50,0,38,38
Early Voting,utah,UT,Trump,39,56,0,6,6
Early Voting,vermont,VT,Biden,80,17,3,0,3
Early Voting,virginia,VA,Biden,65,33,13,0,13
Early Voting,washington,WA,Biden,60,38,12,0,12
Early Voting,west-virginia,WV,Trump,37,61,0,5,5
Early Voting,wisconsin,WI,Biden,62,37,10,0,10
Election Day,alabama,AL,Trump,31,67,0,9,9
Election Day,california,CA,Trump,41,57,0,55,55
Election Day,nevada,NV,Trump,30,67,0,6,6
Election Day,idaho,ID,Trump,12,86,0,4,4
Election Day,utah,UT,Trump,18,80,0,6,6
Election Day,arizona,AZ,Trump,33,66,0,11,11
Election Day,new-mexico,NM,Trump,34,63,0,5,5
Election Day,colorado,CO,Trump,32,66,0,9,9
Election Day,oklahoma,OK,Trump,26,73,0,7,7
Election Day,texas,TX,Trump,36,62,0,38,38
Election Day,louisiana,LA,Trump,34,64,0,8,8
Election Day,arkansas,AR,Trump,32,65,0,6,6
Election Day,missouri,MO,Trump,34,64,0,10,10
Election Day,iowa,IA,Trump,22,75,0,6,6
Election Day,minnesota,MN,Trump,32,66,0,10,10
Election Day,wisconsin,WI,Trump,26,72,0,10,10
Election Day,michigan,MI,Trump,28,70,0,16,16
Election Day,illinois,IL,Trump,34,64,0,20,20
Election Day,mississippi,MS,Trump,36,63,0,6,6
Election Day,georgia,GA,Trump,33,65,0,16,16
Election Day,florida,FL,Trump,30,69,0,29,29
Election Day,north-carolina,NC,Trump,32,67,0,15,15
Election Day,virginia,VA,Trump,33,66,0,13,13
Election Day,west-virginia,WV,Trump,18,80,0,5,5
Election Day,kentucky,KY,Trump,18,80,0,8,8
Election Day,pennsylvania,PA,Trump,32,67,0,20,20
Election Day,new-york,NY,Trump,38,60,0,29,29
Election Day,new-jersey,NJ,Trump,43,56,0,14,14
Election Day,massachusetts,MA,Trump,40,58,0,11,11
Election Day,maine,ME,Trump,33,63,0,4,4
Election Day,new-hampshire,NH,Trump,43,55,0,4,4
Election Day,rhode-island,RI,Trump,34,64,0,4,4
Election Day,connecticut,CT,Trump,46,52,0,7,7
Election Day,maryland,MD,Trump,44,55,0,10,10
Election Day,ohio,OH,Trump,29,69,0,18,18
Election Day,indiana,IN,Trump,30,68,0,11,11
Election Day,nebraska,NE,Trump,20,76,0,5,5
Election Day,kansas,KS,Trump,18,80,0,6,6
Election Day,tennessee,TN,Trump,28,68,0,11,11
Election Day,delaware,DE,Trump,46,52,0,3,3
Election Day,alaska,AK,Trump,22,72,0,3,3
Election Day,south-carolina,SC,Trump,35,64,0,9,9
HS or Less,alabama,AL,Trump,33,66,0,9,9
HS or Less,arizona,AZ,Trump,49,50,0,11,11
HS or Less,arkansas,AR,Trump,26,70,0,6,6
HS or Less,california,CA,Biden,62,36,55,0,55
HS or Less,colorado,CO,Trump,47,51,0,9,9
HS or Less,connecticut,CT,Biden,52,45,7,0,7
HS or Less,delaware,DE,Biden,61,39,3,0,3
HS or Less,florida,FL,Trump,50,50,0,29,29
HS or Less,georgia,GA,Trump,47,52,0,16,16
HS or Less,illinois,IL,Biden,54,44,20,0,20
HS or Less,indiana,IN,Trump,37,62,0,11,11
HS or Less,iowa,IA,Trump,44,54,0,6,6
HS or Less,kansas,KS,Trump,29,69,0,6,6
HS or Less,kentucky,KY,Trump,32,67,0,8,8
HS or Less,louisiana,LA,Trump,35,64,0,8,8
HS or Less,maine,ME,Trump,46,53,0,4,4
HS or Less,maryland,MD,Biden,57,42,10,0,10
HS or Less,massachusetts,MA,Biden,57,40,11,0,11
HS or Less,michigan,MI,Trump,46,53,0,16,16
HS or Less,minnesota,MN,Trump,45,54,0,10,10
HS or Less,mississippi,MS,Trump,33,67,0,6,6
HS or Less,missouri,MO,Trump,34,65,0,10,10
HS or Less,montana,MT,Trump,33,65,0,3,3
HS or Less,nebraska,NE,Trump,40,58,0,5,5
HS or Less,nevada,NV,Trump,48,50,0,6,6
HS or Less,new-hampshire,NH,Biden,50,48,4,0,4
HS or Less,new-jersey,NJ,Biden,54,44,14,0,14
HS or Less,new-mexico,NM,Trump,48,51,0,5,5
HS or Less,new-york,NY,Trump,49,50,0,29,29
HS or Less,north-carolina,NC,Trump,45,55,0,15,15
HS or Less,ohio,OH,Trump,41,58,0,18,18
HS or Less,oklahoma,OK,Trump,29,70,0,7,7
HS or Less,oregon,OR,Trump,47,51,0,7,7
HS or Less,pennsylvania,PA,Trump,42,57,0,20,20
HS or Less,south-carolina,SC,Trump,45,54,0,9,9
HS or Less,tennessee,TN,Trump,31,67,0,11,11
HS or Less,texas,TX,Trump,46,53,0,38,38
HS or Less,utah,UT,Trump,36,60,0,6,6
HS or Less,virginia,VA,Biden,51,48,13,0,13
HS or Less,washington,WA,Biden,52,46,12,0,12
HS or Less,west-virginia,WV,Trump,19,80,0,5,5
HS or Less,wisconsin,WI,Trump,46,53,0,10,10
Married,alabama,AL,Trump,31,68,0,9,9
Married,arizona,AZ,Trump,43,55,0,11,11
Married,california,CA,Biden,54,44,55,0,55
Married,colorado,CO,Biden,50,46,9,0,9
Married,connecticut,CT,Biden,54,45,7,0,7
Married,delaware,DE,Biden,54,44,3,0,3
Married,florida,FL,Trump,39,60,0,29,29
Married,georgia,GA,Trump,40,60,0,16,16
Married,illinois,IL,Biden,54,44,20,0,20
Married,indiana,IN,Trump,33,65,0,11,11
Married,iowa,IA,Trump,37,61,0,6,6
Married,kansas,KS,Trump,37,60,0,6,6
Married,kentucky,KY,Trump,34,63,0,8,8
Married,louisiana,LA,Trump,29,69,0,8,8
Married,maine,ME,Trump,50,50,0,4,4
Married,maryland,MD,Biden,60,39,10,0,10
Married,massachusetts,MA,Biden,63,35,11,0,11
Married,michigan,MI,Trump,44,53,0,16,16
Married,minnesota,MN,Trump,47,51,0,10,10
Married,mississippi,MS,Trump,32,67,0,6,6
Married,missouri,MO,Trump,36,63,0,10,10
Married,montana,MT,Trump,35,64,0,3,3
Married,nebraska,NE,Trump,35,62,0,5,5
Married,nevada,NV,Trump,44,54,0,6,6
Married,new-hampshire,NH,Trump,44,54,0,4,4
Married,new-jersey,NJ,Biden,54,44,14,0,14
Married,new-mexico,NM,Trump,47,52,0,5,5
Married,new-york,NY,Trump,48,51,0,29,29
Married,north-carolina,NC,Trump,41,58,0,15,15
Married,ohio,OH,Trump,36,62,0,18,18
Married,oregon,OR,Biden,55,43,7,0,7
Married,pennsylvania,PA,Trump,45,53,0,20,20
Married,south-carolina,SC,Trump,34,65,0,9,9
Married,tennessee,TN,Trump,31,65,0,11,11
Married,texas,TX,Trump,42,57,0,38,38
Married,utah,UT,Trump,34,61,0,6,6
Married,virginia,VA,Trump,48,51,0,13,13
Married,washington,WA,Biden,54,45,12,0,12
Married,wisconsin,WI,Trump,43,56,0,10,10
Men,alabama,AL,Trump,32,66,0,9,9
Men,alaska,AK,Trump,36,60,0,3,3
Men,arizona,AZ,Trump,46,52,0,11,11
Men,arkansas,AR,Trump,33,66,0,6,6
Men,california,CA,Biden,59,39,55,0,55
Men,colorado,CO,Trump,49,49,0,9,9
Men,connecticut,CT,Biden,53,45,7,0,7
Men,delaware,DE,Biden,52,46,3,0,3
Men,florida,FL,Trump,44,55,0,29,29
Men,georgia,GA,Trump,44,54,0,16,16
Men,hawaii,HI,Biden,55,41,4,0,4
Men,idaho,ID,Trump,27,72,0,4,4
Men,illinois,IL,Biden,52,46,20,0,20
Men,indiana,IN,Trump,38,59,0,11,11
Men,iowa,IA,Trump,41,57,0,6,6
Men,kansas,KS,Trump,37,59,0,6,6
Men,kentucky,KY,Trump,33,65,0,8,8
Men,louisiana,LA,Trump,36,62,0,8,8
Men,maine,ME,Biden,50,46,4,0,4
Men,maryland,MD,Biden,62,36,10,0,10
Men,massachusetts,MA,Biden,57,41,11,0,11
Men,michigan,MI,Trump,43,55,0,16,16
Men,minnesota,MN,Trump,48,50,0,10,10
Men,mississippi,MS,Trump,37,61,0,6,6
Men,missouri,MO,Trump,38,60,0,10,10
Men,montana,MT,Trump,36,61,0,3,3
Men,nebraska,NE,Trump,37,59,0,5,5
Men,nevada,NV,Trump,44,53,0,6,6
Men,new-hampshire,NH,Trump,47,51,0,4,4
Men,new-jersey,NJ,Trump,49,49,0,14,14
Men,new-mexico,NM,Biden,51,46,5,0,5
Men,new-york,NY,Biden,51,47,29,0,29
Men,north-carolina,NC,Trump,45,54,0,15,15
Men,ohio,OH,Trump,40,57,0,18,18
Men,oklahoma,OK,Trump,26,72,0,7,7
Men,oregon,OR,Biden,51,46,7,0,7
Men,pennsylvania,PA,Trump,47,52,0,20,20
Men,rhode-island,RI,Biden,59,39,4,0,4
Men,south-carolina,SC,Trump,36,62,0,9,9
Men,tennessee,TN,Trump,33,65,0,11,11
Men,texas,TX,Trump,43,55,0,38,38
Men,utah,UT,Trump,35,61,0,6,6
Men,virginia,VA,Biden,50,48,13,0,13
Men,washington,WA,Biden,54,43,12,0,12
Men,west-virginia,WV,Trump,30,68,0,5,5
Men,wisconsin,WI,Trump,45,53,0,10,10
Moderate,alabama,AL,Biden,55,42,9,0,9
Moderate,alaska,AK,Biden,53,41,3,0,3
Moderate,arizona,AZ,Biden,59,37,11,0,11
Moderate,arkansas,AR,Trump,39,56,0,6,6
Moderate,california,CA,Biden,70,27,55,0,55
Moderate,colorado,CO,Biden,62,34,9,0,9
Moderate,connecticut,CT,Biden,62,35,7,0,7
Moderate,delaware,DE,Biden,73,25,3,0,3
Moderate,florida,FL,Biden,57,41,29,0,29
Moderate,georgia,GA,Biden,65,32,16,0,16
Moderate,hawaii,HI,Biden,68,29,4,0,4
Moderate,idaho,ID,Trump,47,49,0,4,4
Moderate,illinois,IL,Biden,66,31,20,0,20
Moderate,indiana,IN,Biden,53,43,11,0,11
Moderate,iowa,IA,Biden,61,36,6,0,6
Moderate,kansas,KS,Biden,53,42,6,0,6
Moderate,kentucky,KY,Trump,47,51,0,8,8
Moderate,louisiana,LA,Biden,51,45,8,0,8
Moderate,maine,ME,Biden,62,35,4,0,4
Moderate,maryland,MD,Biden,73,26,10,0,10
Moderate,massachusetts,MA,Biden,63,33,11,0,11
Moderate,michigan,MI,Biden,62,36,16,0,16
Moderate,minnesota,MN,Biden,63,34,10,0,10
Moderate,mississippi,MS,Biden,52,46,6,0,6
Moderate,missouri,MO,Biden,52,44,10,0,10
Moderate,montana,MT,Biden,56,40,3,0,3
Moderate,nebraska,NE,Biden,57,37,5,0,5
Moderate,nevada,NV,Biden,59,38,6,0,6
Moderate,new-hampshire,NH,Biden,56,41,4,0,4
Moderate,new-jersey,NJ,Biden,63,35,14,0,14
Moderate,new-mexico,NM,Biden,68,28,5,0,5
Moderate,new-york,NY,Biden,62,36,29,0,29
Moderate,north-carolina,NC,Biden,62,36,15,0,15
Moderate,ohio,OH,Biden,57,40,18,0,18
Moderate,oklahoma,OK,Trump,46,52,0,7,7
Moderate,oregon,OR,Biden,64,33,7,0,7
Moderate,pennsylvania,PA,Biden,59,39,20,0,20
Moderate,rhode-island,RI,Biden,66,33,4,0,4
Moderate,south-carolina,SC,Biden,66,32,9,0,9
Moderate,tennessee,TN,Biden,53,44,11,0,11
Moderate,texas,TX,Biden,65,33,38,0,38
Moderate,utah,UT,Biden,52,44,6,0,6
Moderate,virginia,VA,Biden,65,32,13,0,13
Moderate,washington,WA,Biden,65,30,12,0,12
Moderate,west-virginia,WV,Trump,41,53,0,5,5
Moderate,wisconsin,WI,Biden,64,34,10,0,10
Post Grad,alabama,AL,Trump,44,53,0,9,9
Post Grad,alaska,AK,Biden,55,43,3,0,3
Post Grad,arizona,AZ,Biden,54,45,11,0,11
Post Grad,california,CA,Biden,64,34,55,0,55
Post Grad,colorado,CO,Biden,60,37,9,0,9
Post Grad,connecticut,CT,Biden,65,33,7,0,7
Post Grad,delaware,DE,Biden,65,34,3,0,3
Post Grad,florida,FL,Trump,49,50,0,29,29
Post Grad,georgia,GA,Biden,54,44,16,0,16
Post Grad,hawaii,HI,Biden,58,39,4,0,4
Post Grad,illinois,IL,Biden,67,32,20,0,20
Post Grad,indiana,IN,Biden,48,46,11,0,11
Post Grad,iowa,IA,Biden,59,39,6,0,6
Post Grad,kansas,KS,Biden,57,39,6,0,6
Post Grad,kentucky,KY,Trump,44,54,0,8,8
Post Grad,louisiana,LA,Biden,50,48,8,0,8
Post Grad,maine,ME,Biden,64,29,4,0,4
Post Grad,maryland,MD,Biden,71,27,10,0,10
Post Grad,massachusetts,MA,Biden,75,23,11,0,11
Post Grad,michigan,MI,Biden,56,42,16,0,16
Post Grad,minnesota,MN,Biden,65,33,10,0,10
Post Grad,mississippi,MS,Trump,46,53,0,6,6
Post Grad,missouri,MO,Trump,48,50,0,10,10
Post Grad,montana,MT,Biden,66,30,3,0,3
Post Grad,nebraska,NE,Biden,50,49,5,0,5
Post Grad,nevada,NV,Biden,53,45,6,0,6
Post Grad,new-hampshire,NH,Biden,60,37,4,0,4
Post Grad,new-jersey,NJ,Biden,60,39,14,0,14
Post Grad,new-mexico,NM,Biden,61,35,5,0,5
Post Grad,new-york,NY,Biden,65,33,29,0,29
Post Grad,north-carolina,NC,Biden,56,43,15,0,15
Post Grad,ohio,OH,Biden,52,44,18,0,18
Post Grad,oregon,OR,Biden,72,26,7,0,7
Post Grad,pennsylvania,PA,Biden,60,39,20,0,20
Post Grad,south-carolina,SC,Trump,48,50,0,9,9
Post Grad,tennessee,TN,Trump,47,51,0,11,11
Post Grad,texas,TX,Biden,50,49,38,0,38
Post Grad,utah,UT,Trump,43,51,0,6,6
Post Grad,virginia,VA,Biden,57,40,13,0,13
Post Grad,washington,WA,Biden,64,32,12,0,12
Post Grad,wisconsin,WI,Biden,66,33,10,0,10
Protestant,alabama,AL,Trump,23,75,0,9,9
Protestant,washington,WA,Trump,42,56,0,12,12
Protestant,oregon,OR,Trump,40,58,0,7,7
Protestant,california,CA,Trump,49,50,0,55,55
Protestant,nevada,NV,Trump,31,68,0,6,6
Protestant,idaho,ID,Trump,30,69,0,4,4
Protestant,utah,UT,Trump,40,55,0,6,6
Protestant,arizona,AZ,Trump,35,64,0,11,11
Protestant,new-mexico,NM,Trump,28,70,0,5,5
Protestant,colorado,CO,Trump,40,58,0,9,9
Protestant,montana,MT,Trump,26,71,0,3,3
Protestant,oklahoma,OK,Trump,25,73,0,7,7
Protestant,texas,TX,Trump,34,65,0,38,38
Protestant,louisiana,LA,Trump,35,63,0,8,8
Protestant,arkansas,AR,Trump,26,73,0,6,6
Protestant,missouri,MO,Trump,32,66,0,10,10
Protestant,iowa,IA,Trump,34,64,0,6,6
Protestant,minnesota,MN,Trump,44,54,0,10,10
Protestant,wisconsin,WI,Trump,40,59,0,10,10
Protestant,michigan,MI,Trump,41,58,0,16,16
Protestant,illinois,IL,Trump,48,50,0,20,20
Protestant,mississippi,MS,Trump,29,70,0,6,6
Protestant,georgia,GA,Trump,32,66,0,16,16
Protestant,florida,FL,Trump,35,64,0,29,29
Protestant,north-carolina,NC,Trump,37,62,0,15,15
Protestant,virginia,VA,Trump,44,54,0,13,13
Protestant,west-virginia,WV,Trump,23,76,0,5,5
Protestant,kentucky,KY,Trump,29,70,0,8,8
Protestant,pennsylvania,PA,Trump,40,59,0,20,20
Protestant,new-york,NY,Biden,50,49,29,0,29
Protestant,new-jersey,NJ,Biden,58,40,14,0,14
Protestant,massachusetts,MA,Biden,56,43,11,0,11
Protestant,maine,ME,Trump,40,58,0,4,4
Protestant,new-hampshire,NH,Trump,38,60,0,4,4
Protestant,connecticut,CT,Biden,58,41,7,0,7
Protestant,maryland,MD,Biden,54,44,10,0,10
Protestant,ohio,OH,Trump,35,63,0,18,18
Protestant,indiana,IN,Trump,33,64,0,11,11
Protestant,nebraska,NE,Trump,30,69,0,5,5
Protestant,kansas,KS,Trump,34,64,0,6,6
Protestant,tennessee,TN,Trump,28,70,0,11,11
Protestant,delaware,DE,Trump,47,51,0,3,3
Protestant,alaska,AK,Trump,27,68,0,3,3
Protestant,south-carolina,SC,Trump,31,67,0,9,9
Rural,alabama,AL,Trump,23,77,0,9,9
Rural,washington,WA,Trump,44,54,0,12,12
Rural,oregon,OR,Trump,36,61,0,7,7
Rural,california,CA,Biden,51,46,55,0,55
Rural,nevada,NV,Trump,40,58,0,6,6
Rural,idaho,ID,Trump,25,73,0,4,4
Rural,utah,UT,Trump,17,79,0,6,6
Rural,arizona,AZ,Trump,43,55,0,11,11
Rural,new-mexico,NM,Trump,44,55,0,5,5
Rural,colorado,CO,Trump,34,63,0,9,9
Rural,montana,MT,Trump,28,70,0,3,3
Rural,oklahoma,OK,Trump,21,78,0,7,7
Rural,texas,TX,Trump,26,73,0,38,38
Rural,louisiana,LA,Trump,28,70,0,8,8
Rural,arkansas,AR,Trump,26,72,0,6,6
Rural,missouri,MO,Trump,21,77,0,10,10
Rural,iowa,IA,Trump,35,63,0,6,6
Rural,minnesota,MN,Trump,34,65,0,10,10
Rural,wisconsin,WI,Trump,36,63,0,10,10
Rural,michigan,MI,Trump,34,64,0,16,16
Rural,illinois,IL,Trump,35,63,0,20,20
Rural,mississippi,MS,Trump,31,68,0,6,6
Rural,georgia,GA,Trump,30,69,0,16,16
Rural,florida,FL,Trump,36,63,0,29,29
Rural,north-carolina,NC,Trump,34,65,0,15,15
Rural,virginia,VA,Trump,36,62,0,13,13
Rural,west-virginia,WV,Trump,19,79,0,5,5
Rural,kentucky,KY,Trump,22,77,0,8,8
Rural,pennsylvania,PA,Trump,30,68,0,20,20
Rural,new-york,NY,Trump,43,56,0,29,29
Rural,new-jersey,NJ,Trump,44,56,0,14,14
Rural,massachusetts,MA,Biden,52,45,11,0,11
Rural,maine,ME,Trump,49,49,0,4,4
Rural,vermont,VT,Biden,67,30,3,0,3
Rural,new-hampshire,NH,Biden,50,49,4,0,4
Rural,connecticut,CT,Trump,47,51,0,7,7
Rural,maryland,MD,Trump,38,59,0,10,10
Rural,ohio,OH,Trump,29,69,0,18,18
Rural,indiana,IN,Trump,27,70,0,11,11
Rural,nebraska,NE,Trump,21,77,0,5,5
Rural,kansas,KS,Trump,25,72,0,6,6
Rural,tennessee,TN,Trump,26,72,0,11,11
Rural,delaware,DE,Trump,48,49,0,3,3
Rural,alaska,AK,Trump,37,61,0,3,3
Rural,south-carolina,SC,Trump,42,58,0,9,9
Single,arizona,AZ,Biden,59,40,11,0,11
Single,california,CA,Biden,71,27,55,0,55
Single,colorado,CO,Biden,72,27,9,0,9
Single,connecticut,CT,Biden,68,29,7,0,7
Single,florida,FL,Biden,62,38,29,0,29
Single,georgia,GA,Biden,61,37,16,0,16
Single,illinois,IL,Biden,65,33,20,0,20
Single,indiana,IN,Biden,63,34,11,0,11
Single,iowa,IA,Biden,63,35,6,0,6
Single,kentucky,KY,Trump,43,54,0,8,8
Single,louisiana,LA,Biden,66,33,8,0,8
Single,maryland,MD,Biden,75,25,10,0,10
Single,massachusetts,MA,Biden,73,22,11,0,11
Single,michigan,MI,Biden,56,42,16,0,16
Single,minnesota,MN,Biden,61,38,10,0,10
Single,missouri,MO,Biden,55,43,10,0,10
Single,nevada,NV,Biden,63,33,6,0,6
Single,new-jersey,NJ,Biden,68,30,14,0,14
Single,new-york,NY,Biden,71,28,29,0,29
Single,north-carolina,NC,Biden,63,36,15,0,15
Single,ohio,OH,Biden,58,40,18,0,18
Single,oregon,OR,Biden,61,37,7,0,7
Single,pennsylvania,PA,Biden,65,34,20,0,20
Single,south-carolina,SC,Biden,68,31,9,0,9
Single,texas,TX,Biden,66,33,38,0,38
Single,virginia,VA,Biden,71,26,13,0,13
Single,washington,WA,Biden,75,20,12,0,12
Single,wisconsin,WI,Biden,60,38,10,0,10
Small Town,alabama,AL,Trump,34,64,0,9,9
Small Town,washington,WA,Biden,51,46,12,0,12
Small Town,oregon,OR,Trump,48,50,0,7,7
Small Town,california,CA,Biden,61,38,55,0,55
Small Town,nevada,NV,Trump,39,59,0,6,6
Small Town,idaho,ID,Trump,28,69,0,4,4
Small Town,utah,UT,Trump,20,75,0,6,6
Small Town,arizona,AZ,Trump,41,58,0,11,11
Small Town,new-mexico,NM,Biden,56,42,5,0,5
Small Town,colorado,CO,Biden,50,49,9,0,9
Small Town,montana,MT,Trump,45,52,0,3,3
Small Town,oklahoma,OK,Trump,25,73,0,7,7
Small Town,texas,TX,Trump,38,61,0,38,38
Small Town,louisiana,LA,Trump,34,64,0,8,8
Small Town,arkansas,AR,Trump,28,66,0,6,6
Small Town,missouri,MO,Trump,28,70,0,10,10
Small Town,iowa,IA,Trump,40,59,0,6,6
Small Town,minnesota,MN,Trump,43,55,0,10,10
Small Town,wisconsin,WI,Trump,48,50,0,10,10
Small Town,michigan,MI,Trump,49,50,0,16,16
Small Town,illinois,IL,Trump,40,57,0,20,20
Small Town,mississippi,MS,Trump,45,53,0,6,6
Small Town,georgia,GA,Trump,36,61,0,16,16
Small Town,florida,FL,Trump,44,55,0,29,29
Small Town,north-carolina,NC,Trump,45,55,0,15,15
Small Town,virginia,VA,Trump,45,54,0,13,13
Small Town,west-virginia,WV,Trump,33,65,0,5,5
Small Town,kentucky,KY,Trump,33,66,0,8,8
Small Town,pennsylvania,PA,Trump,46,53,0,20,20
Small Town,new-york,NY,Trump,44,54,0,29,29
Small Town,new-jersey,NJ,Trump,48,51,0,14,14
Small Town,massachusetts,MA,Biden,58,41,11,0,11
Small Town,maine,ME,Biden,52,46,4,0,4
Small Town,new-hampshire,NH,Biden,54,43,4,0,4
Small Town,connecticut,CT,Biden,52,47,7,0,7
Small Town,maryland,MD,Biden,52,47,10,0,10
Small Town,ohio,OH,Trump,33,65,0,18,18
Small Town,indiana,IN,Trump,39,60,0,11,11
Small Town,nebraska,NE,Trump,30,66,0,5,5
Small Town,kansas,KS,Trump,31,67,0,6,6
Small Town,tennessee,TN,Trump,26,72,0,11,11
Small Town,delaware,DE,Biden,50,49,3,0,3
Small Town,alaska,AK,Biden,50,46,3,0,3
Small Town,south-carolina,SC,Trump,41,58,0,9,9
Some College,alabama,AL,Trump,36,63,0,9,9
Some College,alaska,AK,Trump,37,58,0,3,3
Some College,arizona,AZ,Trump,47,51,0,11,11
Some College,arkansas,AR,Trump,34,63,0,6,6
Some College,california,CA,Biden,62,36,55,0,55
Some College,colorado,CO,Biden,51,47,9,0,9
Some College,connecticut,CT,Biden,56,42,7,0,7
Some College,delaware,DE,Biden,55,43,3,0,3
Some College,florida,FL,Trump,45,53,0,29,29
Some College,georgia,GA,Trump,48,50,0,16,16
Some College,hawaii,HI,Biden,55,42,4,0,4
Some College,idaho,ID,Trump,31,67,0,4,4
Some College,illinois,IL,Biden,53,44,20,0,20
Some College,indiana,IN,Trump,39,59,0,11,11
Some College,iowa,IA,Trump,40,59,0,6,6
Some College,kansas,KS,Trump,38,58,0,6,6
Some College,kentucky,KY,Trump,35,64,0,8,8
Some College,louisiana,LA,Trump,42,56,0,8,8
Some College,maine,ME,Trump,45,52,0,4,4
Some College,maryland,MD,Biden,64,34,10,0,10
Some College,massachusetts,MA,Biden,56,42,11,0,11
Some College,michigan,MI,Trump,49,49,0,16,16
Some College,minnesota,MN,Trump,49,49,0,10,10
Some College,mississippi,MS,Trump,43,54,0,6,6
Some College,missouri,MO,Trump,41,57,0,10,10
Some College,montana,MT,Trump,33,63,0,3,3
Some College,nebraska,NE,Trump,32,66,0,5,5
Some College,nevada,NV,Biden,49,48,6,0,6
Some College,new-hampshire,NH,Trump,46,51,0,4,4
Some College,new-jersey,NJ,Biden,51,47,14,0,14
Some College,new-mexico,NM,Biden,55,43,5,0,5
Some College,new-york,NY,Trump,48,50,0,29,29
Some College,north-carolina,NC,Trump,46,53,0,15,15
Some College,ohio,OH,Trump,43,55,0,18,18
Some College,oklahoma,OK,Trump,36,62,0,7,7
Some College,oregon,OR,Biden,49,48,7,0,7
Some College,pennsylvania,PA,Trump,49,50,0,20,20
Some College,rhode-island,RI,Biden,60,39,4,0,4
Some College,south-carolina,SC,Trump,43,56,0,9,9
Some College,tennessee,TN,Trump,40,59,0,11,11
Some College,texas,TX,Trump,46,53,0,38,38
Some College,utah,UT,Trump,34,63,0,6,6
Some College,virginia,VA,Trump,48,50,0,13,13
Some College,washington,WA,Biden,55,42,12,0,12
Some College,west-virginia,WV,Trump,30,68,0,5,5
Some College,wisconsin,WI,Trump,46,52,0,10,10
Suburban,alabama,AL,Trump,42,55,0,9,9
Suburban,washington,WA,Biden,59,38,12,0,12
Suburban,oregon,OR,Biden,64,34,7,0,7
Suburban,california,CA,Biden,64,34,55,0,55
Suburban,nevada,NV,Trump,48,49,0,6,6
Suburban,idaho,ID,Trump,35,62,0,4,4
Suburban,utah,UT,Trump,41,54,0,6,6
Suburban,arizona,AZ,Trump,48,51,0,11,11
Suburban,new-mexico,NM,Biden,58,39,5,0,5
Suburban,colorado,CO,Biden,58,39,9,0,9
Suburban,montana,MT,Trump,48,48,0,3,3
Suburban,oklahoma,OK,Trump,39,59,0,7,7
Suburban,texas,TX,Biden,50,49,38,0,38
Suburban,louisiana,LA,Trump,37,62,0,8,8
Suburban,arkansas,AR,Trump,46,52,0,6,6
Suburban,missouri,MO,Biden,50,47,10,0,10
Suburban,iowa,IA,Biden,50,48,6,0,6
Suburban,minnesota,MN,Biden,56,42,10,0,10
Suburban,wisconsin,WI,Biden,51,47,10,0,10
Suburban,michigan,MI,Biden,54,44,16,0,16
Suburban,illinois,IL,Biden,61,37,20,0,20
Suburban,mississippi,MS,Trump,39,59,0,6,6
Suburban,georgia,GA,Biden,55,43,16,0,16
Suburban,florida,FL,Trump,48,51,0,29,29
Suburban,north-carolina,NC,Biden,55,43,15,0,15
Suburban,virginia,VA,Biden,61,37,13,0,13
Suburban,west-virginia,WV,Trump,40,56,0,5,5
Suburban,kentucky,KY,Trump,46,52,0,8,8
Suburban,pennsylvania,PA,Biden,54,44,20,0,20
Suburban,new-york,NY,Trump,49,49,0,29,29
Suburban,new-jersey,NJ,Biden,59,40,14,0,14
Suburban,massachusetts,MA,Biden,65,33,11,0,11
Suburban,maine,ME,Biden,63,31,4,0,4
Suburban,new-hampshire,NH,Biden,52,46,4,0,4
Suburban,rhode-island,RI,Biden,58,39,4,0,4
Suburban,connecticut,CT,Biden,62,36,7,0,7
Suburban,maryland,MD,Biden,70,28,10,0,10
Suburban,ohio,OH,Biden,50,48,18,0,18
Suburban,indiana,IN,Trump,43,53,0,11,11
Suburban,nebraska,NE,Trump,43,54,0,5,5
Suburban,kansas,KS,Biden,52,45,6,0,6
Suburban,tennessee,TN,Trump,40,58,0,11,11
Suburban,delaware,DE,Biden,62,36,3,0,3
Suburban,alaska,AK,Trump,35,59,0,3,3
Suburban,hawaii,HI,Biden,57,40,4,0,4
Suburban,south-carolina,SC,Trump,44,55,0,9,9
"Under $25,000",alabama,AL,Trump,48,51,0,9,9
"Under $25,000",arizona,AZ,Biden,50,48,11,0,11
"Under $25,000",arkansas,AR,Trump,33,65,0,6,6
"Under $25,000",california,CA,Biden,76,22,55,0,55
"Under $25,000",colorado,CO,Biden,60,37,9,0,9
"Under $25,000",connecticut,CT,Biden,66,31,7,0,7
"Under $25,000",florida,FL,Biden,54,45,29,0,29
"Under $25,000",georgia,GA,Biden,54,44,16,0,16
"Under $25,000",illinois,IL,Biden,61,36,20,0,20
"Under $25,000",indiana,IN,Trump,47,52,0,11,11
"Under $25,000",iowa,IA,Biden,58,41,6,0,6
"Under $25,000",kansas,KS,Trump,46,50,0,6,6
"Under $25,000",kentucky,KY,Trump,37,61,0,8,8
"Under $25,000",louisiana,LA,Biden,53,45,8,0,8
"Under $25,000",maine,ME,Biden,54,44,4,0,4
"Under $25,000",maryland,MD,Biden,74,25,10,0,10
"Under $25,000",massachusetts,MA,Biden,67,32,11,0,11
"Under $25,000",michigan,MI,Biden,60,40,16,0,16
"Under $25,000",minnesota,MN,Biden,56,42,10,0,10
"Under $25,000",mississippi,MS,Trump,49,49,0,6,6
"Under $25,000",missouri,MO,Trump,40,58,0,10,10
"Under $25,000",montana,MT,Trump,43,49,0,3,3
"Under $25,000",nebraska,NE,Trump,43,54,0,5,5
"Under $25,000",nevada,NV,Biden,58,39,6,0,6
"Under $25,000",new-hampshire,NH,Biden,62,36,4,0,4
"Under $25,000",new-jersey,NJ,Biden,64,34,14,0,14
"Under $25,000",new-mexico,NM,Biden,62,36,5,0,5
"Under $25,000",new-york,NY,Biden,61,38,29,0,29
"Under $25,000",north-carolina,NC,Biden,53,46,15,0,15
"Under $25,000",ohio,OH,Biden,53,47,18,0,18
"Under $25,000",oklahoma,OK,Trump,37,60,0,7,7
"Under $25,000",oregon,OR,Biden,51,44,7,0,7
"Under $25,000",pennsylvania,PA,Biden,54,46,20,0,20
"Under $25,000",south-carolina,SC,Biden,60,39,9,0,9
"Under $25,000",tennessee,TN,Trump,41,58,0,11,11
"Under $25,000",texas,TX,Biden,53,46,38,0,38
"Under $25,000",utah,UT,Trump,41,52,0,6,6
"Under $25,000",virginia,VA,Biden,63,35,13,0,13
"Under $25,000",washington,WA,Biden,60,37,12,0,12
"Under $25,000",west-virginia,WV,Trump,28,70,0,5,5
"Under $25,000",wisconsin,WI,Biden,61,37,10,0,10
Urban,alabama,AL,Biden,59,40,9,0,9
Urban,washington,WA,Biden,74,25,12,0,12
Urban,oregon,OR,Biden,72,25,7,0,7
Urban,california,CA,Biden,68,30,55,0,55
Urban,nevada,NV,Biden,59,39,6,0,6
Urban,utah,UT,Biden,59,38,6,0,6
Urban,arizona,AZ,Biden,59,40,11,0,11
Urban,new-mexico,NM,Biden,60,37,5,0,5
Urban,colorado,CO,Biden,66,32,9,0,9
Urban,montana,MT,Biden,54,42,3,0,3
Urban,oklahoma,OK,Trump,43,55,0,7,7
Urban,texas,TX,Biden,58,41,38,0,38
Urban,louisiana,LA,Biden,67,32,8,0,8
Urban,missouri,MO,Biden,67,32,10,0,10
Urban,iowa,IA,Biden,62,36,6,0,6
Urban,minnesota,MN,Biden,75,23,10,0,10
Urban,wisconsin,WI,Biden,66,34,10,0,10
Urban,michigan,MI,Biden,68,31,16,0,16
Urban,illinois,IL,Biden,72,26,20,0,20
Urban,mississippi,MS,Biden,61,38,6,0,6
Urban,georgia,GA,Biden,68,31,16,0,16
Urban,florida,FL,Biden,55,44,29,0,29
Urban,north-carolina,NC,Biden,64,35,15,0,15
Urban,virginia,VA,Biden,63,34,13,0,13
Urban,kentucky,KY,Biden,61,38,8,0,8
Urban,pennsylvania,PA,Biden,67,32,20,0,20
Urban,new-york,NY,Biden,73,25,29,0,29
Urban,new-jersey,NJ,Biden,67,31,14,0,14
Urban,massachusetts,MA,Biden,78,20,11,0,11
Urban,maine,ME,Biden,54,42,4,0,4
Urban,new-hampshire,NH,Biden,52,46,4,0,4
Urban,connecticut,CT,Biden,70,27,7,0,7
Urban,maryland,MD,Biden,79,20,10,0,10
Urban,ohio,OH,Biden,63,36,18,0,18
Urban,indiana,IN,Biden,57,42,11,0,11
Urban,nebraska,NE,Biden,60,39,5,0,5
Urban,kansas,KS,Biden,50,47,6,0,6
Urban,tennessee,TN,Biden,67,31,11,0,11
Urban,delaware,DE,Biden,74,23,3,0,3
Urban,alaska,AK,Biden,51,47,3,0,3
Urban,hawaii,HI,Biden,68,30,4,0,4
Urban,south-carolina,SC,Biden,54,43,9,0,9
White,wyoming,WY,Trump,28,69,0,3,3
White,wisconsin,WI,Trump,48,51,0,10,10
White,west-virginia,WV,Trump,27,71,0,5,5
White,washington,WA,Biden,57,40,12,0,12
White,virginia,VA,Trump,45,52,0,13,13
White,vermont,VT,Biden,67,31,3,0,3
White,utah,UT,Trump,37,59,0,6,6
White,texas,TX,Trump,32,67,0,38,38
White,tennessee,TN,Trump,29,69,0,11,11
White,south-dakota,SD,Trump,35,63,0,3,3
White,south-carolina,SC,Trump,29,69,0,9,9
White,rhode-island,RI,Biden,57,41,4,0,4
White,pennsylvania,PA,Trump,45,54,0,20,20
White,oregon,OR,Biden,57,40,7,0,7
White,oklahoma,OK,Trump,28,71,0,7,7
White,ohio,OH,Trump,39,59,0,18,18
White,north-dakota,ND,Trump,31,66,0,3,3
White,north-carolina,NC,Trump,38,61,0,15,15
White,new-york,NY,Trump,47,52,0,29,29
White,new-mexico,NM,Biden,49,48,5,0,5
White,new-jersey,NJ,Biden,50,49,14,0,14
White,new-hampshire,NH,Biden,53,45,4,0,4
White,nevada,NV,Trump,45,53,0,6,6
White,nebraska,NE,Trump,37,61,0,5,5
White,montana,MT,Trump,39,57,0,3,3
White,missouri,MO,Trump,36,62,0,10,10
White,mississippi,MS,Trump,18,81,0,6,6
White,minnesota,MN,Biden,51,47,10,0,10
White,michigan,MI,Trump,45,53,0,16,16
White,massachusetts,MA,Biden,63,35,11,0,11
White,maryland,MD,Biden,52,46,10,0,10
White,maine,ME,Biden,54,44,4,0,4
White,louisiana,LA,Trump,22,77,0,8,8
White,kentucky,KY,Trump,32,66,0,8,8
White,kansas,KS,Trump,38,59,0,6,6
White,iowa,IA,Trump,44,54,0,6,6
White,indiana,IN,Trump,36,61,0,11,11
White,illinois,IL,Biden,50,49,20,0,20
White,idaho,ID,Trump,32,64,0,4,4
White,hawaii,HI,Biden,63,35,4,0,4
White,georgia,GA,Trump,29,69,0,16,16
White,florida,FL,Trump,39,61,0,29,29
White,delaware,DE,Biden,50,48,3,0,3
White,connecticut,CT,Biden,55,43,7,0,7
White,colorado,CO,Biden,53,44,9,0,9
White,california,CA,Biden,56,42,55,0,55
White,arkansas,AR,Trump,26,72,0,6,6
White,arizona,AZ,Trump,45,53,0,11,11
White,alaska,AK,Trump,44,53,0,3,3
White,alabama,AL,Trump,20,78,0,9,9
Women,alabama,AL,Trump,40,59,0,9,9
Women,alaska,AK,Biden,52,45,3,0,3
Women,arizona,AZ,Biden,52,47,11,0,11
Women,arkansas,AR,Trump,36,60,0,6,6
Women,california,CA,Biden,68,30,55,0,55
Women,colorado,CO,Biden,61,36,9,0,9
Women,connecticut,CT,Biden,64,34,7,0,7
Women,delaware,DE,Biden,64,34,3,0,3
Women,florida,FL,Biden,51,48,29,0,29
Women,georgia,GA,Biden,54,44,16,0,16
Women,hawaii,HI,Biden,71,28,4,0,4
Women,idaho,ID,Trump,38,58,0,4,4
Women,illinois,IL,Biden,63,36,20,0,20
Women,indiana,IN,Trump,43,55,0,11,11
Women,iowa,IA,Trump,48,50,0,6,6
Women,kansas,KS,Trump,45,53,0,6,6
Women,kentucky,KY,Trump,39,59,0,8,8
Women,louisiana,LA,Trump,43,56,0,8,8
Women,maine,ME,Biden,56,43,4,0,4
Women,maryland,MD,Biden,68,31,10,0,10
Women,massachusetts,MA,Biden,72,26,11,0,11
Women,michigan,MI,Biden,58,41,16,0,16
Women,minnesota,MN,Biden,57,42,10,0,10
Women,mississippi,MS,Trump,43,56,0,6,6
Women,missouri,MO,Trump,45,55,0,10,10
Women,montana,MT,Trump,44,53,0,3,3
Women,nebraska,NE,Trump,41,57,0,5,5
Women,nevada,NV,Biden,56,42,6,0,6
Women,new-hampshire,NH,Biden,57,41,4,0,4
Women,new-jersey,NJ,Biden,64,35,14,0,14
Women,new-mexico,NM,Biden,57,41,5,0,5
Women,new-york,NY,Biden,60,39,29,0,29
Women,north-carolina,NC,Biden,52,47,15,0,15
Women,north-dakota,ND,Trump,38,58,0,3,3
Women,ohio,OH,Trump,49,50,0,18,18
Women,oklahoma,OK,Trump,37,62,0,7,7
Women,oregon,OR,Biden,62,36,7,0,7
Women,pennsylvania,PA,Biden,52,47,20,0,20
Women,rhode-island,RI,Biden,60,39,4,0,4
Women,south-carolina,SC,Trump,49,49,0,9,9
Women,south-dakota,SD,Trump,41,58,0,3,3
Women,tennessee,TN,Trump,41,57,0,11,11
Women,texas,TX,Trump,49,50,0,38,38
Women,utah,UT,Trump,41,56,0,6,6
Women,vermont,VT,Biden,78,20,3,0,3
Women,virginia,VA,Biden,57,41,13,0,13
Women,washington,WA,Biden,62,35,12,0,12
Women,west-virginia,WV,Trump,29,69,0,5,5
Women,wisconsin,WI,Biden,53,46,10,0,10
